{   
    "Levels": {
        "Level 1": [
            "##############################",
            "#                            #",
            "#                            #",
            "#                            #",
            "#                      G     #",
            "#                            #",
            "#                            #",
            "#                            #",
            "#                            #",
            "#              B             #",
            "#                            #",
            "#                            #",
            "#                            #",
            "#                            #",
            "#                            #",
            "#                            #",
            "#       P                    #",
            "#                            #",
            "#                            #",
            "##############################"
        ],
    
        "Level 2": [
            "##############################",
            "##############################",
            "##############################",
            "##############################",
            "##############################",
            "############        G#########",
            "############         #########",
            "############   ###############",
            "############## ###############",
            "############## ###############",
            "############## ###############",
            "#############  ###############",
            "###########    ###############",
            "#########PB    ###############",
            "###########   ################",
            "##############################",
            "##############################",
            "##############################",
            "##############################",
            "##############################"
        ],

        "Level 3": [
            "##############################",
            "##############################",
            "##############################",
            "##############################",
            "##############G###############",
            "############## ###############",
            "############## ###############",
            "############## ###############",
            "##############B###############",
            "#########G   BPB   G##########",
            "##############B###############",
            "############## ###############",
            "############## ###############",
            "############## ###############",
            "##############G###############",
            "##############################",
            "##############################",
            "##############################",
            "##############################",
            "##############################"
        ],

        "Level 4": [
            "##############################",
            "##############################",
            "##############################",
            "##############################",
            "##############################",
            "##############################",
            "#######P ####  ###### G#######",
            "#######  ####  ######  #######",
            "#######        ######  #######",
            "#######   B    ######  #######",
            "#######  ####  ######  #######",
            "#######  ####  ######  #######",
            "#                            #",
            "#                            #",
            "#####  ################  #####",
            "######  ##############  ######",
            "#######                #######",
            "##############################",
            "##############################",
            "##############################"
        ],

        "Level 5": [
            "##############################",
            "##############################",
            "############     #############",
            "############ B   #############",
            "############     #############",
            "############## ###############",
            "############## ###############",
            "############## ###############",
            "######    #### ###############",
            "######  P                   G#",
            "######    #### ######### #####",
            "############## ######### #####",
            "############## ######### #####",
            "############## ######### #####",
            "############     #####   #####",
            "############             #####",
            "############     ######  #####",
            "##############################",
            "##############################",
            "##############################"
        ],

        "Level 6": [
            "##############################",
            "##############################",
            "##############################",
            "####G        B             ###",
            "####                       ###",
            "####  P                   G###",
            "####                       ###",
            "####                       ###",
            "####              B        ###",
            "####                       ###",
            "####      B                ###",
            "####                       ###",
            "####                       ###",
            "####                       ###",
            "####   B                 B ###",
            "####                       ###",
            "####            G          ###",
            "##############################",
            "##############################",
            "##############################"
        ],

        "Level 7": [
            "##############################",
            "##############################",
            "##############################",
            "##############################",
            "##############################",
            "##############################",
            "#####     ##########     #####",
            "#####  P  ###   ####     #####",
            "#####     ###            #####",
            "#####            ###  G  #####",
            "#####     ######         #####",
            "#####  B  ##########     #####",
            "#####     ##########     #####",
            "##############################",
            "##############################",
            "##############################",
            "##############################",
            "##############################",
            "##############################",
            "##############################"
        ],

        "Level 8": [
            "##############################",
            "##############################",
            "##############################",
            "##############################",
            "##############################",
            "####################  G#######",
            "###################     ######",
            "##################      ######",
            "################      ########",
            "##############      ##########",
            "############      ############",
            "##########      ##############",
            "########      ################",
            "######      ##################",
            "#### B    ####################",
            "####P   ######################",
            "##############################",
            "##############################",
            "##############################",
            "##############################"
        ],

        "Level 9": [
            "##############################",
            "############## P #############",
            "############### ##############",
            "######   ###### ##############",
            "######   ###### ##############",
            "###   B        G##############",
            "### ##   ###### ##############",
            "### ########### ##############",
            "### ##   ###### ##############",
            "###   B        G##############",
            "### ##   ###### ##############",
            "### ########### ##############",
            "### ##   ###### ##############",
            "###   B        G##############",
            "######   #####################",
            "######   #####################",
            "##############################",
            "##############################",
            "##############################",
            "##############################"
        ],

        "Level 10": [
            "##############################",
            "##############################",
            "##############################",
            "##############################",
            "#     # ### ##   ## ### # ## #",
            "### ### ### # ### #  ## # # ##",
            "### ###     #P B G# # # #  ###",
            "### ### ### # ### # ##  # # ##",
            "### ### ### # ### # ### # ## #",
            "##############################",
            "##############################",
            "####### ### ##   ## ### ######",
            "######## # ## ### # ### ######",
            "######### ### ### # ### ######",
            "######### ### ### # ### ######",
            "######### ####   ###   #######",
            "##############################",
            "##############################",
            "##############################",
            "##############################"
        ]
    }
}