{   
    "Levels": {
        "Level 1": [
            "##############################",
            "#                            #",
            "#                            #",
            "#                            #",
            "#                      G     #",
            "#                            #",
            "#                            #",
            "#                            #",
            "#                            #",
            "#              B             #",
            "#                            #",
            "#                            #",
            "#                            #",
            "#                            #",
            "#                            #",
            "#     P                      #",
            "#                            #",
            "#                            #",
            "#                            #",
            "##############################"
        ]
    }
}